111111111111111111111111
1CC100110C1000C1000010C1
100000E10110000000001001
100100110000010000101001
100100000011110C01100001
100001011000C10000001001
1111010C1011110001111011
1C01010010000101001C0001
100100001011010100100001
100001011C10010100C00001
111101001110010101111001
1C00011010C00100001C0001
110101000010010100000101
110101111010010101111101
10C100C0001C000100C1P001
111111111111111111111111
